l=9,c=9
202002001
010200000
000003010
302000104
020706010
201000104
020500000
000003010
200300202
 
