x:12 y:16
0 1 -3 -3 4 -3 3 -4 4 -3 1 0
3 -3 -3 1 -2 0 0 0 -1 1 -3 2
-2 0 2 -4 8 -4 -4 2 -2 0 1 -1
-2 0 0 0 -2 0 3 -3 2 0 -1 2
3 0 2 -3 5 0 -2 4 -4 -4 5 -1
-1 0 -1 0 -2 1 -2 -2 1 0 -2 2
5 -4 7 -4 4 -1 -2 4 -1 0 2 -1
-2 0 -2 0 0 -1 2 -2 3 -4 -4 5
-2 0 4 -3 -3 4 -4 7 -3 -3 1 -2
3 0 -1 0 3 -3 3 -2 0 0 0 -2
-1 0 1 0 -2 0 -2 3 0 2 -4 5
2 -3 -3 1 -2 0 2 -1 0 0 0 -1
0 0 4 -4 7 -3 -3 6 -4 2 0 2
2 0 -2 0 -2 1 0 -2 0 0 0 -1
-2 0 -2 0 2 -1 0 4 -4 -4 2 -1
3 -3 5 -4 -4 4 -3 -3 3 -4 -4 3
