x:11 y:11
0 1 -3 -3 2 -3 -3 2 -3 2 0
2 -3 -3 3 -3 2 -3 -3 1 -1 1
-1 0 0 -1 2 -4 -4 4 -3 2 -1
-1 2 -3 5 -3 -3 1 -1 0 0 -1
1 -1 0 -2 0 2 -3 4 -3 -3 4
0 1 0 -2 0 -1 0 -1 0 1 -4
1 -3 -3 6 -3 2 0 -1 0 -1 4
0 0 0 -2 1 -3 -3 4 -3 2 -2
0 1 -3 5 -3 -3 1 -1 0 0 -2
0 0 0 -1 2 -4 -4 4 -3 -3 3
2 -4 -4 4 -3 -3 2 -3 -3 1 0

