x:5 y:5
0 0 3 0 0
0 0 0 0 0
4 0 6 0 1
0 0 0 0 0
0 0 3 0 0
