x:7 y:7
2 0 0 3 0 1 0
0 0 0 0 0 0 0
3 0 2 0 1 0 2
0 1 0 4 0 2 0
1 0 0 0 1 0 3
0 0 1 0 0 0 0
0 2 0 3 0 0 2
