x:12 y:16
3 0 5 0 0 5 0 0 3 0 0 3
0 1 0 0 0 0 0 4 0 3 0 0
1 0 2 0 1 0 0 0 0 0 1 0
0 2 0 0 0 5 0 5 0 3 0 3
3 0 0 4 0 0 2 0 0 0 2 0
0 0 0 0 0 2 0 1 0 0 0 3
3 0 0 6 0 0 4 0 0 4 0 0
0 0 0 0 0 0 0 1 0 0 0 2
3 0 0 6 0 4 0 0 0 0 2 0
0 0 0 0 1 0 0 2 0 3 0 2
0 2 0 3 0 0 2 0 1 0 2 0
2 0 0 0 2 0 0 3 0 2 0 0
0 0 1 0 0 3 0 0 0 0 0 2
2 0 0 0 2 0 0 4 0 0 3 0
0 1 0 1 0 1 0 0 2 0 0 3
3 0 5 0 4 0 3 0 0 0 1 0
